NO ./textures/north.xpm
SO ./textures/south.xpm
WE ./textures/west.xpm
EA ./textures/east.xpm

F 256,100,0
C 0,150,255

11111
10N01
11111
