NO ./textures/north.xpm
SO ./textures/south.xpm
WE ./textures/west.xpm
EA ./textures/east.xpm

F 220,100,0
C 0,150,255

  1111
  1001
111001
1N0 01
111001
  1001
  1111
