NO ./textures/north.xpm
SO ./textures/south.xpm
WE ./textures/west.xpm
EA ./textures/east.xpm

F 200,150,50
C 135,206,235

111111111111111
100000000000001
101111111111101
101000000000101
101011111110101
101010000010101
101010111010101
101010100010101
101010101110101
10101010E000101
101011111111101
101000000000001
111111111111111
