NO ./textures/north.xpm
SO ./textures/south.xpm
WE ./textures/west.xpm
EA ./textures/east.xpm

F 180,120,60
C 30,100,200

        1111
        1001
  1111111001
  1000000001
  1000S00001
  1000000011
  1011100011
  1010001111
  1010001
  1000001
  1111111
