NO ./textures/north.xpm
SO ./textures/south.xpm
WE ./textures/west.xpm
EA ./textures/east.xpm

F 255,200,150
C 100,180,255

11111111111111111
10000010000010001
10000010000010001
10000010000010001
10000010000000001
11011111111101111
10000000000000001
10000000000000001
10000N00000000001
10000000000000001
11111110111111111
10000010000000001
10000000000010001
10000010000010001
10000010000010001
11111111111111111
