NO ./textures/north.xpm
SO ./textures/south.xpm
WE ./textures/west.xpm
EA ./textures/east.xpm

F 50,50,50
C 0,0,0

11111111111111111
10000000000000001
10010010010010001
10000000000000001
10010010010010001
10000000000000001
10010010010010001
10000000000000001
100100100W0010001
10000000000000001
10010010010010001
10000000000000001
11111111111111111
