NO ./path_to_north_texture.xpm
SO ./path_to_south_texture.xpm
WE ./path_to_west_texture.xpm
EA ./path_to_east_texture.xpm

F 220,100,0
C 225,30,0

1111111
1N00001
1001001
1000001
1111111
